WE   ./utils/sprite/bricksx64.xpm

 EA  ./utils/sprite/wall.xpm
SO        ./utils/sprite/UwU.xpm
NO      ./utils/sprite/pr71.xpm

C       29,50,255
F       255 , 1, 255

1111111111
10000E0001
1110000111
1010000001
1010000001
1010000001
1110000001
1000000001
1111O11111
1000000001
1000000001
1111111111
11111111111
